New York city	NY
Los Angeles city	CA
Chicago city	IL
Houston city	TX
Philadelphia city	PA
Phoenix city	AZ
San Antonio city	TX
San Diego city	CA
Dallas city	TX
San Jose city	CA
Austin city	TX
Jacksonville city	FL
Indianapolis city (balance)	IN
San Francisco city	CA
Columbus city	OH
Fort Worth city	TX
Charlotte city	NC
Detroit city	MI
El Paso city	TX
Memphis city	TN
Boston city	MA
Seattle city	WA
Denver city	CO
Washington city	DC
Nashville-Davidson metropolitan government (balance)	TN
Baltimore city	MD
Louisville/Jefferson County metro government (balance)	KY
Portland city	OR
Oklahoma City city	OK
Milwaukee city	WI
Las Vegas city	NV
Albuquerque city	NM
Tucson city	AZ
Fresno city	CA
Sacramento city	CA
Long Beach city	CA
Kansas City city	MO
Mesa city	AZ
Virginia Beach city	VA
Atlanta city	GA
Colorado Springs city	CO
Raleigh city	NC
Omaha city	NE
Miami city	FL
Oakland city	CA
Tulsa city	OK
Minneapolis city	MN
Cleveland city	OH
Wichita city	KS
Arlington city	TX
New Orleans city	LA
Bakersfield city	CA
Tampa city	FL
Honolulu CDP	HI
Anaheim city	CA
Aurora city	CO
Santa Ana city	CA
saint Louis city	MO
Riverside city	CA
Corpus Christi city	TX
Pittsburgh city	PA
Lexington-Fayette county	KY
Anchorage municipality	AK
Stockton city	CA
Cincinnati city	OH
saint Paul city	MN
Toledo city	OH
Newark city	NJ
Greensboro city	NC
Plano city	TX
Henderson city	NV
Lincoln city	NE
Buffalo city	NY
Fort Wayne city	IN
Jersey City city	NJ
Chula Vista city	CA
Orlando city	FL
saint Petersburg city	FL
Norfolk city	VA
Chandler city	AZ
Laredo city	TX
Madison city	WI
Durham city	NC
Lubbock city	TX
Winston-Salem city	NC
Garland city	TX
Glendale city	AZ
Hialeah city	FL
Reno city	NV
Baton Rouge city	LA
Irvine city	CA
Chesapeake city	VA
Irving city	TX
Scottsdale city	AZ
North Las Vegas city	NV
Fremont city	CA
Gilbert town	AZ
San Bernardino city	CA
Boise City city	ID
Birmingham city	AL
